Scan,ContainScans,BasePeak,MaxIntensity,RetentionTime,MostIntenseMass2Charge,CumulativeIntensity,TotalScans
1,458,430.88818359375,35438,0.00508833333333333,430.888671875,58421,458
2,566,430.888946533203,34902,0.0139683333333333,430.889068603516,119176,1024
3,475,430.889251708984,55613,0.0244583333333333,430.889068603516,209652,1499
6,394,430.888732910156,37231,0.04226,430.889007568359,271274,1893
7,525,430.889190673828,35809,0.0520233333333333,430.889221191406,333868,2418
8,478,430.888641357422,48109,0.0621916666666667,430.888854980469,410778,2896
9,536,430.888885498047,49563,0.0726266666666667,430.888946533203,490521,3432
10,542,430.888916015625,34254,0.0830666666666667,430.889007568359,546605,3974
12,465,430.889038085938,33438,0.09705,430.889190673828,599784,4439
13,524,430.888824462891,40806,0.107005,430.889129638672,666668,4963
16,373,430.888732910156,34057,0.12474,430.888946533203,722139,5336
17,470,430.889068603516,37506,0.134413333333333,430.88916015625,785548,5806
18,419,430.888854980469,36264,0.144895,430.889129638672,845682,6225
19,424,430.888641357422,44590,0.155443333333333,430.888885498047,915726,6649
20,515,430.888641357422,40463,0.165415,430.888854980469,981500,7164
21,449,430.888977050781,42533,0.175516666666667,430.889099121094,1047980,7613
22,493,430.889038085938,64469,0.185908333333333,430.889221191406,1146613,8106
23,481,430.888885498047,50174,0.196446666666667,430.889129638672,1223544,8587
24,451,430.888641357422,54433,0.206575,430.889007568359,1310588,9038
25,446,430.889068603516,56412,0.21636,430.888916015625,1401967,9484
26,401,430.889068603516,51672,0.226153333333333,430.889099121094,1485342,9885
27,454,430.888854980469,56415,0.236686666666667,430.889129638672,1575818,10339
28,521,430.888793945313,59747,0.24713,430.889068603516,1667558,10860
30,405,430.889251708984,58769,0.260786666666667,430.889221191406,1762383,11265
31,487,430.888793945313,49559,0.270425,430.889221191406,1846922,11752
33,488,430.889099121094,51439,0.284901666666667,430.889404296875,1927343,12240
34,351,430.88916015625,50588,0.294858333333333,430.88916015625,2013623,12591
36,446,430.888824462891,49691,0.308235,430.889312744141,2092219,13037
37,493,430.888885498047,50795,0.318188333333333,430.889129638672,2175571,13530
38,508,430.889282226563,50072,0.32814,430.889251708984,2254269,14038
39,485,430.888793945313,54247,0.338713333333333,430.889129638672,2341511,14523
40,477,430.889129638672,52695,0.348766666666667,430.889404296875,2423376,15000
41,539,430.889404296875,71281,0.359156666666667,430.889343261719,2536889,15539
42,426,430.889587402344,51134,0.369651666666667,430.889556884766,2620515,15965
44,425,430.888885498047,46439,0.384041666666667,430.889312744141,2696724,16390
45,467,430.889862060547,47299,0.393558333333333,430.889770507813,2773120,16857
46,460,430.889801025391,53019,0.404045,430.889801025391,2859163,17317
47,470,430.88916015625,74526,0.414601666666667,430.889343261719,2975774,17787
48,472,430.889251708984,57754,0.42502,430.889617919922,3071357,18259
49,485,430.889099121094,49350,0.435515,430.889373779297,3150421,18744
50,524,430.888854980469,49321,0.446003333333333,430.889251708984,3230556,19268
51,430,430.889343261719,46571,0.45654,430.889373779297,3306346,19698
52,386,430.88916015625,43324,0.466986666666667,430.889465332031,3376777,20084
53,515,430.88916015625,48035,0.477468333333333,430.889434814453,3453591,20599
54,438,430.889434814453,53280,0.487956666666667,430.889221191406,3538438,21037
56,511,430.888763427734,53155,0.502043333333333,430.889251708984,3623163,21548
57,451,430.888824462891,58743,0.512011666666667,430.889038085938,3712615,21999
58,459,430.888549804688,57230,0.52259,430.888946533203,3803311,22458
59,474,430.888946533203,65738,0.532468333333333,430.889373779297,3904344,22932
60,469,430.888854980469,53196,0.542911666666667,430.888763427734,3993628,23401
61,515,430.889373779297,54499,0.553405,430.889282226563,4081333,23916
62,459,430.888641357422,54156,0.563895,430.888885498047,4163092,24375
63,556,430.889373779297,56084,0.574378333333333,430.889282226563,4256428,24931
64,434,430.888977050781,58529,0.585145,430.889038085938,4350706,25365
65,425,430.888885498047,60271,0.595045,430.888854980469,4444333,25790
66,402,430.888977050781,61720,0.605208333333333,430.88916015625,4542957,26192
67,432,430.888549804688,54740,0.615741666666667,430.888763427734,4633973,26624
68,563,430.889038085938,57550,0.625958333333333,430.889038085938,4722540,27187
69,472,430.888671875,56991,0.636461666666667,430.889038085938,4815785,27659
70,387,430.888732910156,71211,0.646953333333333,430.888671875,4933876,28046
71,514,430.888702392578,62501,0.656406666666667,430.888977050781,5035282,28560
72,471,430.888549804688,66069,0.666853333333333,430.888641357422,5143688,29031
73,450,430.888854980469,63558,0.676995,430.888885498047,5243077,29481
74,531,430.888763427734,77471,0.687501666666667,430.889068603516,5359028,30012
75,461,430.888916015625,70176,0.698106666666667,430.889068603516,5469317,30473
76,391,430.888763427734,57705,0.708471666666667,430.888763427734,5560636,30864
77,484,430.888885498047,60826,0.71897,430.888854980469,5661298,31348
78,472,430.888610839844,55217,0.729441666666667,430.888916015625,5749074,31820
79,482,430.888977050781,64634,0.739983333333333,430.88916015625,5852316,32302
80,477,430.888763427734,60465,0.750736666666667,430.88916015625,5948210,32779
81,444,430.888702392578,56932,0.760918333333333,430.889099121094,6039294,33223
82,493,430.888977050781,57789,0.77141,430.888977050781,6135221,33716
83,436,430.888854980469,56856,0.781971666666667,430.889099121094,6224045,34152
84,448,430.889129638672,52042,0.792411666666667,430.889282226563,6305779,34600
85,593,430.888854980469,60080,0.802886666666667,430.889038085938,6397441,35193
86,444,430.888885498047,49603,0.81338,430.889190673828,6474905,35637
87,437,430.889282226563,51851,0.823908333333333,430.889221191406,6558962,36074
88,458,430.88916015625,83129,0.834365,430.889373779297,6684316,36532
89,474,430.889068603516,71442,0.844865,430.889465332031,6796702,37006
91,436,430.8896484375,81003,0.859086666666667,430.889556884766,6927001,37442
92,400,430.888793945313,65102,0.869168333333333,430.88916015625,7027100,37842
93,461,430.889465332031,55405,0.879228333333333,430.889495849609,7118593,38303
94,443,430.889068603516,88399,0.889718333333333,430.889343261719,7261240,38746
95,406,430.889007568359,65166,0.900258333333333,430.889373779297,7361138,39152
96,504,430.888824462891,53924,0.9107,430.889068603516,7445212,39656
97,410,430.888854980469,54834,0.921205,430.889129638672,7531764,40066
99,481,430.889221191406,50301,0.935285,430.889282226563,7615122,40547
100,476,430.888763427734,56160,0.945245,430.889221191406,7702146,41023
101,491,430.888854980469,49282,0.955726666666667,430.889068603516,7782229,41514
102,431,430.889373779297,43682,0.966216666666667,430.889404296875,7850448,41945
103,448,430.888916015625,49888,0.976781666666667,430.888885498047,7930411,42393
104,478,430.888946533203,50419,0.987208333333333,430.889282226563,8010504,42871
105,451,430.888977050781,48100,0.9977,430.888916015625,8088176,43322
106,503,430.889007568359,58638,1.00819166666667,430.889282226563,8181008,43825
107,523,430.888916015625,54445,1.01879666666667,430.889068603516,8270393,44348
108,471,430.889343261719,58231,1.02918666666667,430.889312744141,8364310,44819
110,480,430.888885498047,49152,1.04325333333333,430.889221191406,8439763,45299
111,434,430.889038085938,67995,1.053255,430.889282226563,8546670,45733
112,442,430.889404296875,66866,1.06369833333333,430.889404296875,8649207,46175
113,505,430.889190673828,72722,1.07419333333333,430.889404296875,8767773,46680
114,516,430.889282226563,55390,1.0847,430.889373779297,8853841,47196
115,488,430.889251708984,60829,1.09523166666667,430.889251708984,8953905,47684
116,449,430.889251708984,59647,1.105665,430.889373779297,9051211,48133
117,466,430.888824462891,55137,1.11648,430.888885498047,9140880,48599
118,512,430.888854980469,56919,1.12664333333333,430.88916015625,9230277,49111
119,503,430.889221191406,50852,1.1372,430.889373779297,9313584,49614
120,447,430.889312744141,45435,1.14763666666667,430.889343261719,9390204,50061
121,540,430.889068603516,56589,1.15815166666667,430.88916015625,9484406,50601
122,541,430.889190673828,53517,1.16861166666667,430.889282226563,9571163,51142
123,400,430.889282226563,64791,1.17917166666667,430.889251708984,9672297,51542
124,422,430.888549804688,60827,1.18960333333333,430.888671875,9768614,51964
125,386,430.888763427734,60989,1.19960666666667,430.888732910156,9864439,52350
126,380,430.889251708984,55371,1.21022833333333,430.889343261719,9955783,52730
127,462,430.888916015625,50983,1.22063666666667,430.889282226563,10038966,53192
128,472,430.889221191406,60311,1.231115,430.889251708984,10135241,53664
129,414,430.888793945313,64369,1.24159833333333,430.888946533203,10236451,54078
130,413,430.889190673828,66019,1.25195833333333,430.889556884766,10339180,54491
131,404,430.889221191406,70792,1.262525,430.889282226563,10455942,54895
132,383,430.888946533203,65454,1.27295,430.888946533203,10560904,55278
133,432,430.888977050781,58702,1.28377,430.889129638672,10653482,55710
134,421,430.889007568359,57999,1.29393,430.889312744141,10743506,56131
135,484,430.889251708984,61820,1.30447,430.88916015625,10842341,56615
136,473,430.889221191406,54415,1.31490333333333,430.889373779297,10931690,57088
137,499,430.88916015625,68657,1.32539333333333,430.889373779297,11041465,57587
139,476,430.889221191406,73770,1.339485,430.889312744141,11156038,58063
140,517,430.889221191406,73968,1.34978333333333,430.889282226563,11275649,58580
141,439,430.889282226563,67929,1.359925,430.889373779297,11388787,59019
142,500,430.889343261719,83654,1.37045166666667,430.889343261719,11522127,59519
144,438,430.888916015625,71968,1.38492333333333,430.888916015625,11636742,59957
145,528,430.889282226563,73729,1.39487166666667,430.889312744141,11754089,60485
146,446,430.889099121094,67805,1.40537666666667,430.889038085938,11860725,60931
147,491,430.889068603516,74509,1.41593166666667,430.889099121094,11977005,61422
148,497,430.889099121094,71061,1.42635166666667,430.889129638672,12089151,61919
149,487,430.88916015625,61808,1.43685,430.889190673828,12192835,62406
150,441,430.889099121094,78461,1.44735,430.889129638672,12316732,62847
151,479,430.888977050781,65292,1.45787666666667,430.888977050781,12423485,63326
153,447,430.889190673828,64532,1.471855,430.889221191406,12526420,63773
154,369,430.889251708984,68467,1.481815,430.889312744141,12630802,64142
156,470,430.889129638672,59064,1.495875,430.889190673828,12725012,64612
158,417,430.889099121094,66296,1.50935666666667,430.88916015625,12829688,65029
159,477,430.889007568359,63538,1.51933,430.889068603516,12932732,65506
160,387,430.889068603516,60414,1.52984666666667,430.889129638672,13026447,65893
161,475,430.888916015625,49906,1.54030666666667,430.888885498047,13107377,66368
162,475,430.889099121094,51357,1.55090333333333,430.889068603516,13193558,66843
164,386,430.889190673828,84068,1.56485666666667,430.889221191406,13323012,67229
165,435,430.888732910156,77037,1.57483166666667,430.889068603516,13447697,67664
166,500,430.88916015625,59115,1.58532333333333,430.88916015625,13546436,68164
167,435,430.889038085938,56967,1.59582,430.889068603516,13635692,68599
168,492,430.889221191406,55458,1.60633166666667,430.889221191406,13725528,69091
169,471,430.889221191406,54475,1.616775,430.889190673828,13810835,69562
170,469,430.889099121094,61911,1.627275,430.889129638672,13909982,70031
171,487,430.88916015625,69828,1.63778666666667,430.889129638672,14018372,70518
172,449,430.889129638672,59678,1.64831,430.889190673828,14118984,70967
173,435,430.889251708984,54073,1.658745,430.889221191406,14207768,71402
174,479,430.88916015625,65333,1.66923666666667,430.889221191406,14307889,71881
175,443,430.889007568359,49138,1.67973,430.889373779297,14390413,72324
177,390,430.888946533203,61254,1.69395833333333,430.889404296875,14485616,72714
178,441,430.889251708984,72870,1.70392666666667,430.889312744141,14597873,73155
179,523,430.888977050781,61107,1.71441333333333,430.888946533203,14698056,73678
180,387,430.888946533203,74407,1.72506666666667,430.889221191406,14823763,74065
181,466,430.889312744141,56525,1.73539666666667,430.889373779297,14915093,74531
182,412,430.889099121094,69135,1.745885,430.889129638672,15025695,74943
183,496,430.888977050781,60600,1.75636666666667,430.88916015625,15119002,75439
185,435,430.889373779297,60442,1.77044833333333,430.889404296875,15213315,75874
186,413,430.889068603516,61126,1.78041666666667,430.889282226563,15308363,76287
187,516,430.889038085938,62548,1.79089166666667,430.889038085938,15405533,76803
188,450,430.889007568359,71020,1.80147833333333,430.889068603516,15519096,77253
189,452,430.889038085938,64248,1.81187166666667,430.889038085938,15624433,77705
190,449,430.889282226563,60417,1.822365,430.889251708984,15722064,78154
191,445,430.88916015625,75676,1.83286666666667,430.889251708984,15847625,78599
192,438,430.88916015625,73323,1.843425,430.889282226563,15964353,79037
193,510,430.889221191406,100573,1.85385166666667,430.889251708984,16127505,79547
194,438,430.889190673828,98120,1.86434,430.88916015625,16282905,79985
195,463,430.888366699219,82503,1.87486,430.888641357422,16419333,80448
196,472,430.888793945313,86236,1.88432833333333,430.889007568359,16552652,80920
197,426,430.889434814453,77081,1.89363833333333,430.889434814453,16677230,81346
199,411,430.888549804688,66142,1.9077,430.888824462891,16782331,81757
200,446,430.888793945313,66039,1.916865,430.888916015625,16884912,82203
201,502,430.888732910156,57712,1.92565833333333,430.888916015625,16978514,82705
202,491,430.889038085938,62641,1.93494333333333,430.889038085938,17085328,83196
203,474,430.889251708984,54752,1.945415,430.889404296875,17171637,83670
204,687,430.888885498047,49539,1.95595666666667,430.889282226563,17245286,84357
205,516,430.888793945313,45541,1.96533333333333,430.889129638672,17321303,84873
206,447,430.888885498047,66408,1.97471,430.888916015625,17427802,85320
207,537,430.888732910156,81303,1.98424666666667,430.888671875,17554793,85857
208,516,430.889282226563,49377,1.99394,430.8896484375,17635580,86373
209,540,430.888977050781,47704,2.00437166666667,430.88916015625,17712055,86913
210,528,430.88916015625,46423,2.01373666666667,430.889251708984,17784666,87441
211,542,430.889892578125,40729,2.02316833333333,430.890014648438,17849831,87983
215,662,430.888793945313,36622,2.04448666666667,430.889068603516,17912384,88645
216,598,430.88916015625,40268,2.05327166666667,430.889099121094,17977804,89243
217,420,430.888366699219,54087,2.06270833333333,430.888580322266,18067452,89663
218,524,430.889312744141,45939,2.07209333333333,430.889526367188,18145137,90187
219,425,430.889038085938,55898,2.08252666666667,430.889251708984,18232266,90612
220,562,430.889221191406,52538,2.09304,430.889434814453,18314440,91174
221,467,430.888977050781,55291,2.10351833333333,430.889373779297,18401946,91641
222,427,430.889282226563,45695,2.114065,430.889434814453,18475898,92068
223,592,430.889678955078,36635,2.12451,430.889678955078,18534457,92660
224,406,430.889251708984,51351,2.13500833333333,430.889251708984,18613272,93066
225,474,430.889129638672,56659,2.145505,430.889129638672,18708030,93540
226,511,430.88916015625,78410,2.15603,430.88916015625,18829399,94051
227,445,430.889038085938,55306,2.16647666666667,430.889190673828,18920097,94496
228,410,430.889068603516,56331,2.17695166666667,430.88916015625,19009867,94906
229,434,430.889373779297,56369,2.18745833333333,430.889312744141,19098294,95340
230,464,430.888824462891,51504,2.19798833333333,430.88916015625,19178947,95804
231,492,430.889129638672,68998,2.20843666666667,430.889129638672,19291354,96296
232,451,430.888946533203,51125,2.21892833333333,430.88916015625,19372359,96747
233,431,430.889007568359,65104,2.229505,430.888916015625,19474863,97178
234,565,430.888793945313,36084,2.23994833333333,430.888854980469,19530252,97743
235,667,430.889068603516,35480,2.249435,430.889099121094,19588340,98410
236,643,430.888885498047,31326,2.258975,430.889007568359,19640082,99053
237,701,430.888641357422,30481,2.26847833333333,430.889129638672,19688859,99754
238,538,430.888549804688,37869,2.27808833333333,430.888977050781,19746773,100292
239,735,430.888641357422,25488,2.28757666666667,430.889038085938,19793034,101027
240,662,430.888641357422,32772,2.29717666666667,430.889007568359,19847329,101689
241,612,430.888977050781,30186,2.30667,430.889099121094,19896621,102301
243,659,430.888793945313,33076,2.31988166666667,430.889221191406,19949792,102960
244,644,430.88916015625,27664,2.32893166666667,430.889068603516,19997716,103604
245,610,430.888885498047,26069,2.33849833333333,430.889190673828,20040502,104214
246,752,430.888732910156,24598,2.348095,430.889007568359,20084422,104966
247,676,430.888641357422,23287,2.35777666666667,430.889038085938,20123806,105642
250,651,430.888732910156,28430,2.37455333333333,430.889099121094,20170298,106293
253,456,430.889221191406,50900,2.391125,430.889221191406,20250052,106749
254,485,430.889129638672,48131,2.401185,430.889099121094,20325496,107234
256,438,430.889129638672,43519,2.41508666666667,430.889190673828,20394656,107672
257,574,430.888885498047,30029,2.42512,430.888946533203,20443751,108246
258,580,430.88916015625,30638,2.43456833333333,430.889129638672,20492400,108826
259,544,430.888641357422,34709,2.44409833333333,430.889099121094,20549520,109370
260,533,430.888885498047,48567,2.453665,430.888916015625,20625547,109903
262,602,430.888732910156,42863,2.46680833333333,430.888854980469,20694183,110505
263,491,430.889190673828,62398,2.47582666666667,430.889129638672,20796101,110996
264,440,430.889343261719,76641,2.486315,430.889312744141,20917927,111436
265,478,430.889556884766,54366,2.49684666666667,430.889556884766,21005054,111914
266,670,430.888732910156,34723,2.50728666666667,430.889221191406,21065603,112584
267,730,430.888641357422,47818,2.51716,430.889007568359,21141416,113314
269,614,430.888885498047,36149,2.52997,430.888916015625,21199096,113928
270,656,430.888458251953,49734,2.53908,430.888916015625,21277600,114584
272,642,430.888793945313,38633,2.55230833333333,430.888946533203,21339709,115226
274,498,430.888885498047,33053,2.564995,430.889007568359,21393332,115724
275,646,430.88916015625,33051,2.57414,430.889099121094,21448082,116370
277,482,430.888641357422,32087,2.58715833333333,430.888946533203,21500001,116852
280,596,430.888977050781,49324,2.60345,430.889068603516,21576800,117448
281,648,430.888885498047,58986,2.61245833333333,430.888977050781,21668944,118096
283,622,430.888793945313,43350,2.62558,430.889282226563,21736825,118718
284,590,430.888793945313,44732,2.63473166666667,430.889373779297,21809102,119308
285,590,430.889434814453,32167,2.64418166666667,430.889343261719,21863975,119898
286,573,430.888793945313,34160,2.65374,430.889190673828,21920330,120471
288,573,430.88916015625,40819,2.66680333333333,430.889343261719,21989706,121044
289,670,430.889434814453,49541,2.675915,430.889404296875,22066627,121714
290,559,430.888977050781,33718,2.68539833333333,430.889312744141,22117452,122273
291,597,430.888793945313,32643,2.69497,430.889282226563,22171692,122870
292,696,430.888885498047,31452,2.704475,430.889221191406,22227111,123566
295,640,430.889343261719,30642,2.72149,430.889221191406,22280189,124206
296,748,430.88916015625,35185,2.73045,430.889251708984,22335901,124954
297,562,430.889068603516,30045,2.74007833333333,430.889190673828,22383823,125516
298,683,430.888732910156,31062,2.74990166666667,430.889221191406,22433677,126199
299,655,430.889251708984,31118,2.759065,430.889282226563,22483927,126854
300,694,430.889343261719,33097,2.76859666666667,430.889434814453,22536681,127548
301,693,430.888793945313,52382,2.77814166666667,430.889312744141,22618422,128241
302,551,430.888977050781,33182,2.78770333333333,430.889312744141,22672673,128792
303,575,430.889068603516,33720,2.79718333333333,430.889312744141,22725333,129367
304,632,430.888977050781,35061,2.806765,430.889526367188,22778206,129999
305,637,430.888977050781,33018,2.81663666666667,430.889465332031,22832741,130636
306,585,430.889251708984,33567,2.82598166666667,430.889251708984,22893442,131221
307,600,430.889068603516,37405,2.83554833333333,430.88916015625,22952405,131821
308,742,430.888885498047,41815,2.845215,430.888977050781,23021031,132563
309,586,430.88916015625,44329,2.854795,430.88916015625,23086948,133149
310,617,430.889068603516,29584,2.86439166666667,430.889068603516,23137295,133766
312,731,430.888732910156,31925,2.87738,430.88916015625,23190406,134497
313,575,430.889251708984,35056,2.88642333333333,430.889404296875,23245210,135072
315,679,430.888977050781,35514,2.899605,430.889282226563,23302784,135751
316,598,430.888977050781,38337,2.908685,430.889007568359,23364714,136349
317,576,430.888885498047,36157,2.91848333333333,430.889129638672,23422557,136925
318,625,430.888977050781,34673,2.92769833333333,430.88916015625,23478773,137550
319,679,430.888793945313,40637,2.937375,430.889129638672,23543176,138229
320,642,430.888793945313,33436,2.946925,430.889190673828,23600260,138871
322,591,430.888885498047,32621,2.960055,430.889007568359,23651155,139462
323,644,430.888977050781,31029,2.96911166666667,430.888977050781,23702799,140106
324,657,430.889251708984,28614,2.97873666666667,430.889373779297,23751690,140763
325,597,430.88916015625,39767,2.98827833333333,430.889068603516,23818378,141360
326,632,430.888732910156,38329,2.99782666666667,430.889007568359,23881589,141992
328,696,430.888885498047,33277,3.01098166666667,430.888885498047,23936203,142688
329,527,430.888732910156,32792,3.02008833333333,430.888916015625,23988625,143215
330,594,430.888549804688,39234,3.02961833333333,430.888885498047,24050468,143809
332,836,430.889251708984,39712,3.04269333333333,430.88916015625,24115457,144645
334,531,430.889617919922,62757,3.055355,430.889556884766,24215273,145176
335,577,430.889099121094,67756,3.065325,430.889099121094,24321842,145753
337,430,430.889099121094,69999,3.079415,430.889129638672,24434250,146183
338,499,430.88916015625,84648,3.08942,430.889129638672,24570190,146682
339,544,430.88916015625,72086,3.099875,430.889099121094,24683112,147226
340,516,430.88916015625,82134,3.11035833333333,430.889129638672,24815395,147742
341,572,430.888885498047,55175,3.12086666666667,430.888977050781,24902492,148314
343,523,430.888458251953,60253,3.13365666666667,430.888885498047,24999727,148837
344,561,430.888793945313,48215,3.142595,430.889099121094,25077742,149398
345,698,430.888885498047,52571,3.15206166666667,430.889099121094,25162700,150096
347,615,430.888977050781,48124,3.165055,430.889038085938,25238913,150711
349,512,430.888885498047,48013,3.17754,430.888977050781,25315805,151223
350,497,430.888732910156,57504,3.18642166666667,430.889129638672,25407818,151720
351,589,430.888885498047,45454,3.19587333333333,430.889007568359,25478380,152309
353,634,430.888977050781,45253,3.20900333333333,430.889068603516,25546811,152943
355,491,430.888732910156,42557,3.22165333333333,430.889282226563,25617107,153434
356,602,430.889251708984,37479,3.23070666666667,430.889343261719,25675235,154036
358,702,430.889434814453,41969,3.24394333333333,430.889373779297,25742272,154738
360,562,430.889434814453,45586,3.25654833333333,430.889312744141,25816547,155300
361,548,430.889068603516,79298,3.265485,430.889282226563,25939398,155848
362,704,430.889434814453,55533,3.27505833333333,430.889373779297,26027762,156552
363,668,430.888793945313,48905,3.28474333333333,430.889312744141,26102617,157220
364,611,430.888732910156,40446,3.29384833333333,430.88916015625,26173037,157831
365,605,430.889251708984,46149,3.30325333333333,430.889465332031,26248927,158436
366,626,430.889343261719,46674,3.31279,430.889434814453,26323667,159062
367,554,430.888885498047,49972,3.32225833333333,430.889343261719,26399023,159616
368,536,430.889343261719,42709,3.33171666666667,430.889404296875,26468894,160152
369,543,430.889251708984,59184,3.34125666666667,430.889495849609,26564455,160695
370,546,430.889434814453,50412,3.35108666666667,430.889526367188,26643711,161241
371,708,430.888977050781,42031,3.360135,430.889282226563,26712823,161949
372,618,430.888885498047,49080,3.36965333333333,430.889221191406,26788819,162567
373,585,430.889251708984,48166,3.37914333333333,430.889221191406,26864313,163152
374,677,430.889251708984,55141,3.38869666666667,430.889465332031,26951101,163829
375,631,430.889251708984,43190,3.39825,430.889587402344,27021635,164460
376,677,430.88916015625,48975,3.40774833333333,430.889526367188,27101344,165137
377,591,430.888977050781,49999,3.41757833333333,430.889404296875,27185934,165728
378,640,430.889434814453,53243,3.42661,430.889495849609,27272268,166368
379,596,430.889434814453,48827,3.43588666666667,430.889434814453,27348010,166964
380,555,430.888977050781,54077,3.4453,430.889190673828,27436443,167519
381,588,430.888732910156,42700,3.45482166666667,430.889282226563,27501723,168107
382,564,430.888977050781,46786,3.46438666666667,430.889251708984,27576082,168671
383,563,430.888885498047,46913,3.47371166666667,430.889190673828,27650028,169234
384,686,430.889068603516,45764,3.48347,430.889404296875,27720791,169920
385,463,430.88916015625,56109,3.49259666666667,430.889373779297,27807722,170383
386,615,430.889251708984,42031,3.50217833333333,430.889373779297,27873331,170998
388,551,430.88916015625,41469,3.51529666666667,430.889251708984,27936389,171549
389,548,430.888977050781,41628,3.524425,430.889251708984,28003102,172097
390,600,430.889343261719,44622,3.53395666666667,430.889373779297,28076292,172697
393,507,430.889434814453,61676,3.55087,430.889373779297,28169587,173204
394,547,430.889251708984,45299,3.55998,430.889373779297,28240504,173751
395,571,430.889068603516,35356,3.56965833333333,430.889312744141,28298520,174322
396,760,430.889251708984,38628,3.57928666666667,430.889434814453,28364793,175082
397,591,430.889434814453,36233,3.588845,430.889434814453,28422443,175673
398,550,430.888977050781,41299,3.59835333333333,430.889465332031,28489752,176223
400,505,430.889556884766,82159,3.611355,430.889587402344,28622562,176728
402,418,430.888641357422,95563,3.625095,430.888671875,28778306,177146
403,399,430.888641357422,86723,3.633985,430.888641357422,28917783,177545
404,378,430.888641357422,90567,3.64393833333333,430.888580322266,29059526,177923
405,390,430.888641357422,83435,3.65333333333333,430.888702392578,29189961,178313
406,537,430.88916015625,99354,3.66264166666667,430.889129638672,29351233,178850
407,399,430.88916015625,110002,3.67309666666667,430.889190673828,29529922,179249
408,516,430.889038085938,91870,3.68391333333333,430.889007568359,29681370,179765
409,456,430.889068603516,92626,3.694075,430.889129638672,29824710,180221
410,411,430.889282226563,80898,3.7046,430.889312744141,29955829,180632
411,440,430.889129638672,89480,3.715045,430.889129638672,30095617,181072
412,432,430.88916015625,82978,3.72556,430.889129638672,30225465,181504
413,554,430.889465332031,80914,3.73603166666667,430.889465332031,30351545,182058
414,527,430.8896484375,63050,3.74657833333333,430.889739990234,30448856,182585
415,407,430.889282226563,82651,3.75711833333333,430.889312744141,30579551,182992
416,481,430.889251708984,89493,3.767515,430.889251708984,30725013,183473
417,405,430.889251708984,88893,3.77799833333333,430.889251708984,30873869,183878
418,447,430.889068603516,90522,3.78852666666667,430.889007568359,31018370,184325
419,410,430.889099121094,85747,3.79898833333333,430.889099121094,31156213,184735
420,433,430.889038085938,84319,3.80948,430.889007568359,31293494,185168
421,449,430.888458251953,95341,3.81996166666667,430.888427734375,31444987,185617
422,408,430.889129638672,77277,3.829925,430.88916015625,31563924,186025
423,353,430.889190673828,89449,3.84034833333333,430.889190673828,31707509,186378
424,438,430.889251708984,110135,3.851165,430.889221191406,31882724,186816
425,418,430.889190673828,100362,3.86133,430.88916015625,32047269,187234
426,383,430.889099121094,88585,3.87189166666667,430.889099121094,32188837,187617
427,437,430.889190673828,90423,3.88233,430.889129638672,32334115,188054
428,488,430.889343261719,111865,3.89282,430.889312744141,32515162,188542
429,370,430.889099121094,97757,3.903325,430.889038085938,32675031,188912
430,379,430.889068603516,97694,3.91384333333333,430.889007568359,32832602,189291
431,568,430.890075683594,56919,3.92438666666667,430.889953613281,32924564,189859
432,447,430.889251708984,87538,3.93477166666667,430.889190673828,33064755,190306
433,480,430.889007568359,106790,3.945275,430.889007568359,33238025,190786
434,527,430.889190673828,69512,3.95580333333333,430.889404296875,33349021,191313
435,565,430.889862060547,73942,3.96626666666667,430.889831542969,33466548,191878
437,359,430.889099121094,100315,3.98027,430.889038085938,33625000,192237
438,371,430.889007568359,92367,3.99028,430.889038085938,33774607,192608
439,434,430.888946533203,99608,4.00073666666667,430.888916015625,33937044,193042
440,412,430.889129638672,100801,4.01120166666667,430.889068603516,34098205,193454
441,504,430.888916015625,110149,4.02170333333333,430.888885498047,34271546,193958
442,468,430.888977050781,101982,4.03224666666667,430.888885498047,34437280,194426
443,498,430.889434814453,71683,4.04271,430.889465332031,34551830,194924
444,606,430.888977050781,52534,4.05316333333333,430.888946533203,34633191,195530
445,615,430.888732910156,49379,4.06289333333333,430.888977050781,34708811,196145
446,574,430.888732910156,50549,4.072705,430.888824462891,34782970,196719
447,572,430.888641357422,48399,4.08239166666667,430.888946533203,34856706,197291
448,553,430.888885498047,57051,4.09215166666667,430.888946533203,34944839,197844
449,501,430.888793945313,49285,4.10174666666667,430.888946533203,35025136,198345
450,548,430.888793945313,53338,4.11149,430.889221191406,35109235,198893
451,713,430.888793945313,45568,4.12110833333333,430.889251708984,35181318,199606
454,622,430.888732910156,46071,4.13808333333333,430.889251708984,35256826,200228
455,651,430.889251708984,40649,4.14735333333333,430.889221191406,35319517,200879
456,362,430.888366699219,114697,4.157,430.888244628906,35502241,201241
457,639,430.888885498047,60881,4.16661166666667,430.889221191406,35593957,201880
459,603,430.888793945313,48088,4.17992333333333,430.889221191406,35670236,202483
460,719,430.88916015625,46248,4.18926833333333,430.889038085938,35744735,203202
461,483,430.888732910156,49771,4.19905,430.889099121094,35824925,203685
463,691,430.888793945313,50289,4.212485,430.88916015625,35909021,204376
464,625,430.889343261719,55787,4.22164166666667,430.889251708984,35998530,205001
465,593,430.889556884766,86765,4.23122333333333,430.889587402344,36138671,205594
466,609,430.889068603516,63091,4.24170166666667,430.889312744141,36244983,206203
467,611,430.889343261719,61104,4.25125833333333,430.889282226563,36337791,206814
468,512,430.888977050781,59529,4.260935,430.889373779297,36429885,207326
471,580,430.888885498047,44656,4.27753666666667,430.889312744141,36498275,207906
472,629,430.889526367188,44641,4.28693833333333,430.889465332031,36570827,208535
473,650,430.88916015625,40396,4.296975,430.889373779297,36637241,209185
474,565,430.888885498047,38412,4.30689,430.889343261719,36696890,209750
475,524,430.888885498047,45203,4.31712166666667,430.889404296875,36768899,210274
476,639,430.889343261719,39616,4.326605,430.889404296875,36834640,210913
477,522,430.888977050781,36363,4.33656666666667,430.889373779297,36890353,211435
478,560,430.888977050781,39311,4.34646333333333,430.889312744141,36953086,211995
479,559,430.888977050781,39597,4.356315,430.889282226563,37015488,212554
480,612,430.889343261719,44915,4.366145,430.889312744141,37086216,213166
483,646,430.888793945313,34367,4.38312166666667,430.88916015625,37137096,213812
484,536,430.888885498047,57721,4.39256166666667,430.889038085938,37226799,214348
486,656,430.88916015625,36300,4.40599,430.889221191406,37286029,215004
487,634,430.888885498047,39887,4.415525,430.889221191406,37348581,215638
488,635,430.88916015625,39728,4.42551833333333,430.889312744141,37415862,216273
490,620,430.888977050781,42919,4.43908833333333,430.889282226563,37488855,216893
493,575,430.888885498047,50450,4.45579666666667,430.889221191406,37565050,217468
494,431,430.889526367188,62786,4.46511166666667,430.889404296875,37664340,217899
495,575,430.889068603516,84588,4.47491333333333,430.889312744141,37796992,218474
496,607,430.889343261719,57679,4.48510166666667,430.889129638672,37886673,219081
497,481,430.888793945313,50212,4.49472833333333,430.889221191406,37964016,219562
498,656,430.889343261719,55025,4.50475,430.889343261719,38051502,220218
499,521,430.889068603516,51714,4.51463,430.889221191406,38136403,220739
500,587,430.889068603516,55009,4.52449333333333,430.889343261719,38223004,221326
503,704,430.888885498047,60972,4.541435,430.889312744141,38323235,222030
505,447,430.889251708984,130235,4.55464,430.889251708984,38527884,222477
506,361,430.889221191406,111803,4.56465166666667,430.88916015625,38702355,222838
507,404,430.889251708984,107275,4.575105,430.889251708984,38874322,223242
508,359,430.889190673828,90764,4.58559833333333,430.88916015625,39025590,223601
510,383,430.889282226563,87444,4.59963666666667,430.88916015625,39164785,223984
511,537,430.8896484375,53634,4.609695,430.889984130859,39248121,224521
514,649,430.88916015625,47711,4.62710166666667,430.889251708984,39328436,225170
517,614,430.889526367188,51700,4.64352166666667,430.889495849609,39411005,225784
518,532,430.88916015625,52399,4.65290166666667,430.889343261719,39492859,226316
519,588,430.889068603516,47973,4.66268666666667,430.889465332031,39569909,226904
520,539,430.888732910156,53944,4.672495,430.889221191406,39659557,227443
521,608,430.888793945313,59789,4.68214666666667,430.889251708984,39756696,228051
522,451,430.889373779297,104218,4.69188,430.889373779297,39929702,228502
523,370,430.889221191406,99034,4.70238833333333,430.889190673828,40088769,228872
525,610,430.889617919922,63983,4.71644666666667,430.889617919922,40190512,229482
526,367,430.888275146484,118971,4.72642,430.888275146484,40382945,229849
527,365,430.88916015625,103190,4.73608666666667,430.889099121094,40549072,230214
528,376,430.889068603516,93622,4.746635,430.889068603516,40701144,230590
529,415,430.889099121094,98367,4.75706666666667,430.889038085938,40856315,231005
530,472,430.889190673828,114955,4.767575,430.889129638672,41035690,231477
533,493,430.889404296875,84588,4.78532166666667,430.889465332031,41170658,231970
534,611,430.888793945313,60708,4.79529333333333,430.889038085938,41265976,232581
535,567,430.88916015625,70304,4.80501333333333,430.889068603516,41377377,233148
536,642,430.888732910156,58687,4.81481833333333,430.889099121094,41472408,233790
538,565,430.888885498047,58973,4.82810166666667,430.889038085938,41562567,234355
539,617,430.889251708984,49325,4.83732833333333,430.889282226563,41640806,234972
540,478,430.888793945313,51496,4.84715166666667,430.889190673828,41724501,235450
541,408,430.889221191406,94371,4.85697666666667,430.889221191406,41870415,235858
542,371,430.889038085938,85829,4.86745166666667,430.889007568359,42008539,236229
543,387,430.889556884766,57465,4.87793,430.889587402344,42102185,236616
544,641,430.889251708984,46113,4.88841666666667,430.889221191406,42178076,237257
545,569,430.889434814453,44601,4.89848833333333,430.889343261719,42248259,237826
547,510,430.888732910156,44169,4.91215166666667,430.889068603516,42317673,238336
548,683,430.889251708984,41535,4.92145,430.88916015625,42383041,239019
549,530,430.889251708984,41123,4.93141,430.889221191406,42450222,239549
552,582,430.88916015625,57953,4.94855333333333,430.889129638672,42535319,240131
553,561,430.889434814453,49105,4.95804666666667,430.889251708984,42607077,240692
554,537,430.888885498047,46639,4.96820166666667,430.889099121094,42678834,241229
555,547,430.889068603516,43100,4.97814666666667,430.889068603516,42744741,241776
556,661,430.889068603516,42038,4.987995,430.888946533203,42814073,242437
557,655,430.888885498047,37902,4.998015,430.888916015625,42873247,243092
558,554,430.889343261719,36290,5.00807666666667,430.889282226563,42929763,243646
560,637,430.888885498047,30168,5.022025,430.88916015625,42978950,244283
562,613,430.888732910156,35511,5.03511333333333,430.889007568359,43035926,244896
563,569,430.888793945313,32726,5.044615,430.889038085938,43084176,245465
564,616,430.888732910156,36478,5.054545,430.888977050781,43141600,246081
565,620,430.88916015625,48644,5.06445833333333,430.889068603516,43218503,246701
567,575,430.888977050781,45222,5.07797333333333,430.889190673828,43290967,247276
568,550,430.889251708984,40651,5.087355,430.889343261719,43356559,247826
569,567,430.889068603516,34309,5.09729166666667,430.889068603516,43413102,248393
570,591,430.888885498047,42797,5.10715,430.889282226563,43479448,248984
571,554,430.889068603516,34289,5.11741166666667,430.889312744141,43536727,249538
572,581,430.889068603516,39071,5.12682166666667,430.889282226563,43598273,250119
573,662,430.889068603516,36981,5.136615,430.889373779297,43658064,250781
575,582,430.888977050781,36214,5.15052,430.889251708984,43715938,251363
578,544,430.889343261719,47039,5.16706333333333,430.889404296875,43791130,251907
579,554,430.88916015625,41883,5.17625333333333,430.889282226563,43861332,252461
580,676,430.889068603516,34840,5.18602666666667,430.889312744141,43918109,253137
582,530,430.888641357422,40026,5.199445,430.88916015625,43979909,253667
583,582,430.888885498047,35957,5.20863166666667,430.889282226563,44037296,254249
584,572,430.889343261719,41629,5.218525,430.889251708984,44101432,254821
585,606,430.889068603516,49644,5.228375,430.889221191406,44175874,255427
587,638,430.889343261719,35902,5.241945,430.889190673828,44229991,256065
590,667,430.889251708984,31404,5.258825,430.889038085938,44282827,256732
591,641,430.888793945313,32001,5.26814833333333,430.889068603516,44333185,257373
592,614,430.888885498047,31648,5.27801666666667,430.889129638672,44385389,257987
593,588,430.889068603516,37566,5.28810333333333,430.889221191406,44442839,258575
594,591,430.888885498047,47882,5.29788833333333,430.889343261719,44514735,259166
595,679,430.888885498047,37940,5.307885,430.889221191406,44576325,259845
596,635,430.88916015625,29545,5.31819333333333,430.88916015625,44624592,260480
598,677,430.88916015625,33040,5.33149333333333,430.889190673828,44678920,261157
599,624,430.888885498047,31118,5.34092166666667,430.88916015625,44725545,261781
601,643,430.888641357422,25520,5.354825,430.888977050781,44768892,262424
602,538,430.88916015625,25967,5.36461,430.889251708984,44810480,262962
603,679,430.888793945313,41949,5.37481833333333,430.889038085938,44877718,263641
604,485,430.888885498047,30620,5.38522833333333,430.889038085938,44929094,264126
606,537,430.888732910156,34331,5.39861333333333,430.889099121094,44983377,264663
608,634,430.888641357422,45210,5.41169666666667,430.889038085938,45051919,265297
610,597,430.888732910156,37473,5.42488166666667,430.888885498047,45110819,265894
611,560,430.889343261719,38791,5.434275,430.88916015625,45170415,266454
614,610,430.88916015625,31818,5.45125,430.889221191406,45222080,267064
615,581,430.888732910156,56476,5.460795,430.889007568359,45306474,267645
616,513,430.888793945313,31181,5.47069666666667,430.889068603516,45354800,268158
617,586,430.888977050781,36648,5.48069166666667,430.889007568359,45412794,268744
618,642,430.889068603516,35717,5.49058666666667,430.889190673828,45469791,269386
619,600,430.889068603516,40050,5.5005,430.889129638672,45532578,269986
620,603,430.889251708984,37776,5.51051,430.889221191406,45592410,270589
621,631,430.888885498047,32703,5.520445,430.889068603516,45644975,271220
622,652,430.888977050781,33258,5.53044,430.889221191406,45698849,271872
623,554,430.889068603516,35283,5.54042833333333,430.889221191406,45753315,272426
625,529,430.888885498047,28749,5.55411333333333,430.88916015625,45800509,272955
627,635,430.889343261719,34906,5.56716,430.889282226563,45858565,273590
629,567,430.888977050781,36645,5.58021666666667,430.889221191406,45916777,274157
630,502,430.888793945313,40842,5.58962666666667,430.889190673828,45984414,274659
631,650,430.888641357422,37795,5.59948,430.889068603516,46043806,275309
634,564,430.889068603516,42751,5.61657333333333,430.889129638672,46114715,275873
636,619,430.889251708984,34376,5.62976666666667,430.889190673828,46169880,276492
637,555,430.888732910156,30191,5.63926666666667,430.88916015625,46222982,277047
638,583,430.88916015625,27471,5.64937166666667,430.889312744141,46266743,277630
639,696,430.888793945313,28716,5.65949333333333,430.889343261719,46314352,278326
640,543,430.888977050781,30364,5.66955333333333,430.889251708984,46365311,278869
642,561,430.88916015625,27844,5.68321333333333,430.889282226563,46410113,279430
644,609,430.888732910156,31555,5.696345,430.889129638672,46460391,280039
645,573,430.889343261719,31303,5.70584833333333,430.88916015625,46513118,280612
646,628,430.888977050781,36649,5.71598166666667,430.888885498047,46571177,281240
647,558,430.888793945313,38505,5.72604666666667,430.88916015625,46632231,281798
648,629,430.888885498047,35847,5.73598833333333,430.889221191406,46687472,282427
649,601,430.889068603516,35635,5.74609166666667,430.889343261719,46747352,283028
650,485,430.888977050781,37920,5.75608833333333,430.889038085938,46807768,283513
651,589,430.888732910156,32945,5.76605333333333,430.889068603516,46857903,284102
653,736,430.888885498047,34530,5.77961666666667,430.889099121094,46912694,284838
655,557,430.889068603516,28382,5.79277666666667,430.88916015625,46957909,285395
656,588,430.888977050781,36620,5.80253166666667,430.889312744141,47016763,285983
657,594,430.888732910156,35456,5.81249833333333,430.889312744141,47073045,286577
658,366,430.889221191406,64845,5.82251166666667,430.889190673828,47180163,286943
659,384,430.889038085938,67251,5.83302666666667,430.889038085938,47289564,287327
660,375,430.888885498047,60348,5.84356666666667,430.888977050781,47391298,287702
661,399,430.889099121094,61900,5.854015,430.889099121094,47492152,288101
662,367,430.888702392578,62143,5.86448833333333,430.888702392578,47593738,288468
664,521,430.888366699219,35531,5.87853166666667,430.888732910156,47649614,288989
665,600,430.888977050781,39476,5.88788666666667,430.888946533203,47712887,289589
667,668,430.88916015625,32786,5.90120666666667,430.889221191406,47767690,290257
668,607,430.889251708984,30783,5.91069333333333,430.889129638672,47820141,290864
669,602,430.888793945313,34270,5.92072833333333,430.889007568359,47872823,291466
670,551,430.888732910156,35558,5.93068333333333,430.889129638672,47930138,292017
671,581,430.88916015625,39766,5.94063333333333,430.889251708984,47989118,292598
675,606,430.888793945313,40225,5.96153333333333,430.889190673828,48049028,293204
676,592,430.888885498047,43113,5.971075,430.889312744141,48117163,293796
679,544,430.888885498047,44109,5.98839333333333,430.889190673828,48189176,294340
681,553,430.888732910156,40440,6.00141666666667,430.889099121094,48252510,294893
684,598,430.888885498047,36957,6.018075,430.889282226563,48312314,295491
685,468,430.888885498047,45068,6.027595,430.889068603516,48380815,295959
687,657,430.889068603516,44152,6.04109833333333,430.889038085938,48452791,296616
689,521,430.888793945313,39142,6.05422166666667,430.889251708984,48516925,297137
690,515,430.888793945313,40094,6.063815,430.889221191406,48579453,297652
692,574,430.88916015625,44954,6.07736666666667,430.889190673828,48649190,298226
693,600,430.888885498047,36770,6.08677833333333,430.889282226563,48709129,298826
695,610,430.889251708984,43290,6.10034166666667,430.889373779297,48780211,299436
697,600,430.888885498047,41867,6.11348333333333,430.889312744141,48845600,300036
699,644,430.889251708984,42730,6.126585,430.889282226563,48909613,300680
700,603,430.889434814453,40226,6.13626833333333,430.889434814453,48975462,301283
701,496,430.888885498047,39041,6.14637333333333,430.889312744141,49040636,301779
702,645,430.889343261719,44356,6.15632666666667,430.889465332031,49113664,302424
703,640,430.888977050781,74996,6.16637833333333,430.889221191406,49228925,303064
704,549,430.889251708984,43858,6.17654166666667,430.889190673828,49297382,303613
705,671,430.88916015625,37165,6.18664833333333,430.889312744141,49356246,304284
706,546,430.888977050781,49337,6.19679833333333,430.889373779297,49434008,304830
707,500,430.888977050781,41067,6.20675666666667,430.889373779297,49498681,305330
710,551,430.88916015625,38909,6.22397833333333,430.889434814453,49561141,305881
712,653,430.889434814453,36403,6.23702,430.889312744141,49616878,306534
715,633,430.889434814453,54314,6.25364166666667,430.889343261719,49702283,307167
716,569,430.889068603516,41740,6.26315666666667,430.889343261719,49769423,307736
717,660,430.889251708984,46580,6.27308833333333,430.889282226563,49842585,308396
718,611,430.889343261719,40236,6.28344166666667,430.889404296875,49911348,309007
719,702,430.889251708984,39213,6.292925,430.889282226563,49972949,309709
720,659,430.889434814453,38054,6.30277166666667,430.889434814453,50034847,310368
721,648,430.889251708984,38224,6.312895,430.889434814453,50095461,311016
722,512,430.888793945313,34563,6.32284833333333,430.889251708984,50151275,311528
723,569,430.88916015625,44551,6.33277666666667,430.88916015625,50217571,312097
724,484,430.888793945313,46775,6.34267833333333,430.889190673828,50295895,312581
725,566,430.888793945313,47656,6.35258833333333,430.889343261719,50369588,313147
726,623,430.889251708984,48384,6.36252166666667,430.889221191406,50444481,313770
727,729,430.889068603516,42212,6.37244166666667,430.889068603516,50510836,314499
729,617,430.889343261719,49045,6.38590833333333,430.889190673828,50587290,315116
730,565,430.889068603516,52867,6.39537833333333,430.889190673828,50673521,315681
731,615,430.889343261719,57107,6.40522666666667,430.889221191406,50766120,316296
732,576,430.888885498047,62237,6.415,430.889190673828,50864383,316872
734,589,430.889068603516,44492,6.42856,430.889221191406,50935209,317461
735,532,430.888977050781,50628,6.43798,430.889038085938,51012021,317993
736,553,430.888793945313,54962,6.447965,430.889190673828,51093941,318546
737,500,430.889068603516,54224,6.45798666666667,430.889068603516,51176893,319046
740,563,430.888793945313,44970,6.47532,430.888824462891,51248393,319609
741,653,430.888793945313,35569,6.48531833333333,430.889007568359,51304417,320262
742,556,430.889251708984,45832,6.49506666666667,430.889099121094,51374995,320818
743,574,430.889068603516,37717,6.50519166666667,430.889221191406,51439023,321392
744,558,430.888977050781,46499,6.51510333333333,430.889099121094,51512252,321950
745,617,430.88916015625,40557,6.52509833333333,430.889251708984,51573624,322567
746,743,430.888885498047,43705,6.535165,430.888946533203,51642926,323310
747,628,430.888641357422,41160,6.54535166666667,430.889007568359,51705660,323938
749,588,430.888793945313,32357,6.55901,430.889099121094,51760353,324526
751,542,430.888641357422,52300,6.57202166666667,430.889038085938,51840396,325068
752,581,430.888977050781,50066,6.58150333333333,430.889129638672,51916547,325649
753,610,430.888977050781,41441,6.59145166666667,430.889312744141,51983236,326259
755,547,430.889068603516,37938,6.60499333333333,430.889190673828,52045007,326806
756,614,430.888732910156,50986,6.61456,430.889129638672,52122044,327420
757,616,430.889251708984,43003,6.62444166666667,430.889312744141,52193079,328036
758,601,430.889251708984,34630,6.63444833333333,430.889312744141,52247877,328637
759,673,430.889251708984,40808,6.644475,430.889282226563,52315336,329310
761,756,430.889068603516,43757,6.65807833333333,430.889251708984,52390822,330066
762,520,430.889251708984,60348,6.66749,430.889343261719,52487104,330586
764,590,430.889251708984,50310,6.68102166666667,430.889312744141,52564292,331176
765,589,430.88916015625,68581,6.69039166666667,430.889190673828,52669911,331765
766,595,430.888793945313,43708,6.70036333333333,430.889221191406,52740476,332360
767,677,430.889343261719,48080,6.71029,430.889282226563,52814218,333037
769,547,430.888885498047,39508,6.72392833333333,430.889190673828,52879764,333584
770,525,430.889068603516,37530,6.73337333333333,430.889221191406,52940776,334109
772,540,430.88916015625,41080,6.74685166666667,430.889343261719,53010197,334649
774,600,430.889434814453,40904,6.75991166666667,430.889312744141,53077208,335249
776,604,430.88916015625,47690,6.77301333333333,430.889282226563,53150963,335853
777,532,430.88916015625,44310,6.78239166666667,430.889465332031,53220013,336385
778,533,430.889343261719,45307,6.79237333333333,430.889495849609,53294816,336918
779,609,430.889434814453,48719,6.80221333333333,430.889404296875,53370062,337527
780,552,430.889251708984,40679,6.8121,430.889129638672,53437168,338079
781,591,430.88916015625,41845,6.82211,430.88916015625,53499586,338670
782,695,430.889068603516,42613,6.83192333333333,430.88916015625,53565261,339365
784,664,430.888977050781,40617,6.84532333333333,430.889282226563,53629509,340029
785,639,430.889343261719,40603,6.85471333333333,430.889282226563,53696062,340668
786,541,430.889434814453,48181,6.86461166666667,430.889343261719,53771078,341209
787,664,430.888641357422,43643,6.87442833333333,430.889068603516,53837810,341873
789,724,430.888793945313,39761,6.88797666666667,430.889099121094,53900345,342597
790,513,430.889068603516,32929,6.89733333333333,430.889251708984,53956165,343110
791,561,430.888732910156,39189,6.90732833333333,430.889251708984,54017762,343671
792,606,430.888793945313,38901,6.91752166666667,430.889129638672,54081173,344277
793,573,430.888885498047,40663,6.927095,430.889129638672,54144405,344850
795,447,430.889068603516,39616,6.940545,430.889099121094,54208622,345297
796,592,430.888885498047,36740,6.94996166666667,430.889190673828,54268387,345889
797,592,430.888885498047,35859,6.95993166666667,430.88916015625,54326837,346481
798,621,430.889343261719,34578,6.96991333333333,430.889312744141,54379952,347102
799,535,430.888885498047,46881,6.97997833333333,430.88916015625,54452190,347637
801,511,430.888641357422,32250,6.99345833333333,430.889038085938,54507733,348148
802,581,430.888732910156,54559,7.00296,430.889099121094,54589747,348729
804,577,430.888793945313,41130,7.01695,430.889190673828,54655587,349306
806,637,430.888977050781,48751,7.02978,430.889129638672,54730773,349943
808,609,430.889068603516,45901,7.04261833333333,430.889068603516,54803185,350552
810,508,430.888885498047,49723,7.05569,430.889068603516,54883334,351060
811,533,430.889068603516,48152,7.06504833333333,430.889038085938,54957508,351593
812,624,430.888885498047,51716,7.07494166666667,430.889343261719,55038363,352217
813,769,430.88916015625,43968,7.08515166666667,430.889434814453,55111551,352986
814,536,430.888977050781,48102,7.094635,430.889190673828,55184419,353522
815,620,430.88916015625,40479,7.10451833333333,430.889465332031,55250174,354142
817,509,430.888977050781,39811,7.11831666666667,430.889251708984,55315021,354651
818,534,430.889343261719,48201,7.12765833333333,430.889190673828,55391750,355185
820,653,430.889068603516,43565,7.14119666666667,430.889038085938,55463483,355838
822,530,430.889068603516,47584,7.15449166666667,430.889312744141,55543595,356368
824,586,430.889068603516,45930,7.16749833333333,430.889495849609,55616971,356954
825,667,430.889068603516,37513,7.17685666666667,430.889373779297,55677906,357621
827,489,430.888885498047,49666,7.190395,430.889282226563,55755651,358110
828,529,432.886383056641,41953,7.19978166666667,432.886383056641,55864607,358639
829,628,430.888732910156,49050,7.20967,430.889221191406,55939742,359267
830,627,430.888977050781,48243,7.21956833333333,430.889221191406,56017499,359894
832,598,430.88916015625,52207,7.23297,430.889404296875,56100229,360492
833,574,430.888977050781,50013,7.24225833333333,430.889221191406,56178530,361066
834,693,430.889343261719,50349,7.252235,430.889343261719,56261607,361759
835,484,430.888977050781,52657,7.26206,430.889312744141,56342265,362243
836,536,430.889251708984,49803,7.27187,430.889587402344,56420897,362779
837,646,430.88916015625,50236,7.281745,430.889404296875,56501388,363425
838,553,430.889434814453,48501,7.29167,430.889282226563,56577865,363978
839,607,430.889343261719,41888,7.30159,430.889282226563,56643043,364585
840,651,430.889343261719,40317,7.31151166666667,430.889343261719,56705016,365236
841,616,430.889434814453,34447,7.32156166666667,430.889282226563,56758816,365852
843,536,430.888885498047,34977,7.335475,430.889343261719,56816195,366388
844,576,430.889434814453,32117,7.34490333333333,430.889373779297,56867558,366964
845,527,430.889343261719,43642,7.3549,430.889343261719,56931641,367491
846,394,430.889343261719,74497,7.36483166666667,430.889312744141,57052492,367885
847,299,430.889373779297,87213,7.37537666666667,430.889312744141,57186904,368184
848,359,430.889312744141,69291,7.385825,430.889251708984,57301268,368543
849,628,430.889770507813,35837,7.39632333333333,430.89013671875,57361133,369171
850,553,430.888977050781,47338,7.4068,430.889099121094,57435850,369724
851,600,430.889343261719,56162,7.41712666666667,430.889312744141,57520311,370324
852,518,430.889251708984,52224,7.42658,430.889251708984,57600158,370842
853,594,430.888885498047,62372,7.43633,430.889434814453,57700521,371436
854,549,430.889251708984,53936,7.44607166666667,430.889282226563,57786117,371985
855,327,430.888458251953,110411,7.45585166666667,430.888397216797,57963915,372312
857,358,430.889282226563,102554,7.46911166666667,430.889251708984,58126638,372670
858,378,430.889282226563,100446,7.479075,430.889221191406,58283661,373048
859,408,430.889221191406,101520,7.48962,430.889221191406,58445246,373456
860,399,430.889129638672,100136,7.50016166666667,430.889099121094,58608659,373855
861,341,430.88916015625,101158,7.51055333333333,430.889099121094,58766730,374196
862,447,430.889251708984,95460,7.52105166666667,430.889221191406,58918173,374643
863,519,430.88916015625,50491,7.53159166666667,430.889190673828,58998651,375162
864,587,430.889251708984,53607,7.54135833333333,430.889434814453,59086035,375749
865,563,430.888977050781,53127,7.55117833333333,430.889404296875,59172638,376312
866,491,430.889434814453,57607,7.561165,430.889373779297,59259652,376803
867,562,430.889434814453,53737,7.57099833333333,430.889434814453,59344473,377365
868,633,430.889526367188,54245,7.58077333333333,430.889373779297,59433779,377998
869,560,430.889434814453,52427,7.59059666666667,430.889404296875,59519479,378558
870,638,430.889434814453,51064,7.60040833333333,430.889556884766,59598591,379196
871,664,430.889617919922,60626,7.61036666666667,430.889556884766,59692351,379860
872,594,430.88916015625,50480,7.62025333333333,430.889373779297,59777219,380454
873,667,430.889068603516,47282,7.630275,430.889404296875,59850929,381121
875,631,430.88916015625,40847,7.64385333333333,430.889373779297,59917636,381752
876,657,430.889617919922,52225,7.65334,430.889465332031,59999942,382409
877,657,430.889068603516,53579,7.66322,430.889465332031,60086100,383066
878,712,430.889617919922,61036,7.67323,430.889617919922,60180566,383778
879,498,430.889617919922,57074,7.68304333333333,430.889495849609,60269064,384276
881,559,430.889251708984,55594,7.696305,430.889556884766,60357065,384835
882,479,430.888977050781,52708,7.70562833333333,430.889343261719,60442947,385314
883,560,430.889526367188,42535,7.71563833333333,430.889495849609,60513754,385874
884,568,430.889526367188,53923,7.72573666666667,430.889465332031,60598422,386442
885,599,430.889251708984,51383,7.73565666666667,430.889343261719,60678639,387041
886,643,430.888885498047,56025,7.74558833333333,430.889190673828,60763436,387684
888,520,430.889251708984,59021,7.75934333333333,430.88916015625,60852532,388204
889,570,430.888885498047,56732,7.76870166666667,430.889007568359,60941152,388774
890,648,430.888977050781,51074,7.77858833333333,430.889099121094,61023425,389422
892,641,430.888732910156,52453,7.79218166666667,430.888946533203,61103456,390063
894,547,430.888732910156,52980,7.80527,430.888946533203,61187854,390610
895,626,430.888885498047,54716,7.81475,430.888885498047,61271436,391236
896,574,430.888885498047,49180,7.824685,430.888977050781,61348164,391810
897,637,430.888793945313,51561,7.83454666666667,430.888946533203,61429353,392447
899,682,430.888549804688,50835,7.84819,430.888916015625,61507688,393129
900,637,430.888549804688,54327,7.85749833333333,430.888977050781,61593661,393766
901,674,430.888793945313,52991,7.86759333333333,430.889221191406,61676600,394440
902,551,430.888793945313,57562,7.87760333333333,430.889038085938,61769148,394991
904,596,430.88916015625,65831,7.89115,430.889068603516,61878312,395587
906,455,430.888977050781,62383,7.90405666666667,430.889068603516,61974186,396042
907,734,430.88916015625,65832,7.91336166666667,430.889221191406,62080640,396776
911,667,430.888793945313,53386,7.93376333333333,430.889221191406,62163968,397443
912,609,430.889343261719,60589,7.94326166666667,430.88916015625,62258043,398052
914,505,430.889068603516,56607,7.956715,430.889007568359,62344826,398557
915,473,430.888885498047,49813,7.96621,430.888885498047,62422913,399030
916,538,430.889068603516,47425,7.97630666666667,430.889007568359,62496703,399568
918,697,430.888977050781,40534,7.98990333333333,430.889099121094,62559781,400265
920,540,430.888641357422,36370,8.00307666666667,430.889068603516,62616194,400805
921,606,430.888885498047,39371,8.01281,430.889251708984,62678541,401411
922,518,430.888732910156,42407,8.02283666666667,430.889007568359,62749095,401929
923,327,430.88916015625,78503,8.03305333333333,430.889129638672,62873998,402256
924,600,430.888732910156,47832,8.04356,430.889099121094,62950107,402856
925,556,430.888732910156,49007,8.05343,430.889099121094,63031417,403412
927,687,430.888641357422,49488,8.06690333333333,430.888977050781,63105861,404099
928,571,430.888793945313,46660,8.07636833333333,430.888916015625,63177904,404670
929,412,430.88818359375,99927,8.08651666666667,430.88818359375,63341299,405082
930,369,430.888732910156,113044,8.09647333333333,430.888824462891,63522473,405451
932,488,430.888732910156,53723,8.11047333333333,430.888763427734,63609288,405939
933,565,430.888793945313,61213,8.12004333333333,430.888916015625,63705609,406504
934,647,430.888732910156,52640,8.12994833333333,430.889099121094,63792064,407151
935,495,430.888977050781,49829,8.13993166666667,430.889434814453,63872458,407646
938,570,430.889068603516,44687,8.15742333333333,430.889404296875,63941454,408216
939,542,430.88916015625,44376,8.16690666666667,430.889343261719,64015735,408758
940,589,430.889343261719,46156,8.17696333333333,430.889556884766,64092143,409347
941,723,430.889434814453,51837,8.187165,430.889312744141,64177544,410070
942,523,430.889068603516,53487,8.197015,430.889312744141,64264860,410593
944,586,430.88916015625,53047,8.21052666666667,430.889373779297,64345604,411179
945,546,430.888977050781,57561,8.22005166666667,430.889434814453,64431933,411725
946,649,430.889526367188,59154,8.22993666666667,430.889495849609,64522582,412374
948,581,430.888793945313,54788,8.24341,430.889099121094,64607333,412955
949,607,430.889343261719,46636,8.25273166666667,430.889251708984,64685192,413562
951,613,430.888977050781,48534,8.26630166666667,430.889343261719,64763282,414175
953,607,430.889068603516,52093,8.279325,430.889373779297,64844831,414782
954,583,430.889068603516,46647,8.28869166666667,430.889434814453,64917919,415365
955,632,430.889068603516,41735,8.29865,430.889221191406,64987648,415997
956,586,430.889343261719,41291,8.30865666666667,430.889282226563,65053884,416583
957,662,430.889068603516,39303,8.31874333333333,430.889373779297,65116807,417245
958,604,430.88916015625,38096,8.32876,430.889282226563,65177625,417849
959,560,430.889343261719,41015,8.33878,430.889343261719,65241336,418409
960,711,430.889251708984,44024,8.34881,430.889251708984,65312152,419120
961,356,430.889312744141,69923,8.35893333333333,430.889312744141,65426174,419476
962,347,430.889129638672,73283,8.36934,430.889129638672,65542725,419823
963,385,430.888946533203,73359,8.37988166666667,430.888885498047,65665378,420208
964,392,430.889068603516,126292,8.39032333333333,430.889068603516,65867382,420600
965,610,430.889251708984,41423,8.40084166666667,430.889282226563,65935155,421210
967,653,430.888641357422,45945,8.41419166666667,430.888977050781,66009093,421863
969,405,430.889221191406,114356,8.427075,430.889129638672,66189373,422268
970,352,430.88916015625,87967,8.43705,430.88916015625,66333895,422620
971,397,430.889129638672,91689,8.44758,430.88916015625,66487289,423017
972,349,430.888854980469,82412,8.458025,430.888885498047,66624913,423366
973,358,430.888854980469,81553,8.46852166666667,430.888946533203,66761538,423724
974,388,430.889099121094,78207,8.47901,430.889099121094,66885433,424112
975,290,430.88916015625,70949,8.48953333333333,430.889129638672,66999492,424402
976,684,430.889068603516,40603,8.49999,430.889129638672,67064484,425086
978,740,430.889251708984,62521,8.51323833333333,430.889282226563,67161700,425826
979,535,430.889251708984,38000,8.522785,430.889190673828,67223925,426361
980,528,430.888732910156,36931,8.53291,430.889068603516,67280559,426889
981,645,430.888732910156,34761,8.542855,430.889221191406,67335295,427534
982,659,430.888885498047,46133,8.55290166666667,430.88916015625,67408407,428193
983,397,430.889129638672,67285,8.56310166666667,430.889099121094,67520594,428590
984,316,430.889190673828,69067,8.57354,430.889190673828,67630185,428906
985,317,430.889068603516,71904,8.58438333333333,430.889007568359,67746045,429223
987,391,430.889190673828,69592,8.59805333333333,430.88916015625,67863066,429614
988,413,430.889129638672,73596,8.60801333333333,430.88916015625,67983638,430027
989,337,430.889129638672,78676,8.61851166666667,430.889129638672,68112835,430364
990,504,430.88916015625,42957,8.62900333333333,430.889251708984,68180497,430868
991,548,430.889526367188,39464,8.63893333333333,430.889343261719,68244461,431416
993,397,430.889373779297,106402,8.6524,430.889343261719,68411835,431813
994,360,430.889099121094,80839,8.66237666666667,430.889129638672,68548032,432173
995,616,430.888885498047,43663,8.67291333333333,430.889129638672,68618917,432789
996,531,430.88916015625,41088,8.68306833333333,430.889190673828,68684486,433320
997,614,430.88916015625,77314,8.69264333333333,430.889251708984,68806340,433934
998,658,430.889434814453,47184,8.70267333333333,430.889251708984,68878901,434592
999,690,430.888977050781,57931,8.71261,430.889068603516,68973542,435282
1000,730,430.889251708984,36948,8.72258,430.889343261719,69033564,436012
1001,673,430.889068603516,45168,8.73258666666667,430.889190673828,69101956,436685
1002,591,430.889068603516,53521,8.742525,430.889221191406,69191217,437276
1004,444,430.889282226563,77345,8.756085,430.889251708984,69316720,437720
1005,418,430.889465332031,72268,8.76605,430.889373779297,69437890,438138
1006,353,430.889099121094,68267,8.77652333333333,430.88916015625,69552014,438491
1008,378,430.889068603516,71244,8.7906,430.889099121094,69669399,438869
1009,467,430.888885498047,29447,8.80057666666667,430.889068603516,69722141,439336
1010,579,430.888977050781,45663,8.81045166666667,430.889251708984,69793901,439915
1011,287,430.888000488281,74411,8.82039666666667,430.887969970703,69917776,440202
1012,595,430.88916015625,33502,8.83037,430.889282226563,69967689,440797
1013,343,430.889068603516,66883,8.84029,430.889007568359,70075117,441140
1014,376,430.889007568359,62998,8.851105,430.889068603516,70183252,441516
1015,364,430.888916015625,74846,8.861315,430.888946533203,70300322,441880
1016,282,430.888854980469,68568,8.87187,430.888916015625,70410695,442162
1017,412,430.888580322266,73341,8.88225666666667,430.888702392578,70528384,442574
1018,352,430.888824462891,93729,8.89276166666667,430.888916015625,70681718,442926
1019,393,430.888946533203,78641,8.90329833333333,430.888977050781,70808836,443319
1020,617,430.888732910156,36107,8.91373666666667,430.889129638672,70868986,443936
1022,677,430.888977050781,56424,8.927065,430.889099121094,70955075,444613
1024,376,430.889099121094,71918,8.940015,430.889068603516,71074951,444989
1025,662,430.888549804688,40357,8.95031666666667,430.888946533203,71140973,445651
1026,653,430.889068603516,32103,8.95968666666667,430.889282226563,71191875,446304
1028,397,430.889007568359,69218,8.97315833333333,430.888977050781,71306514,446701
1029,394,430.889038085938,65406,8.98311833333333,430.889068603516,71413339,447095
1030,351,430.888946533203,130844,8.99361333333333,430.889007568359,71626642,447446
1031,373,430.88916015625,70079,9.00409,430.889068603516,71740527,447819
1032,399,430.888977050781,74151,9.01464666666667,430.888977050781,71858750,448218
1035,365,430.889282226563,80635,9.03208166666667,430.889221191406,71992049,448583
1036,566,430.888732910156,79179,9.04215,430.889007568359,72116403,449149
1038,686,430.889068603516,59972,9.05531833333333,430.889099121094,72218082,449835
1039,506,430.889068603516,50151,9.06446166666667,430.888916015625,72294722,450341
1040,404,430.889190673828,87340,9.07421333333333,430.889129638672,72431497,450745
1041,379,430.888977050781,87513,9.08511166666667,430.888946533203,72572430,451124
1042,404,430.889068603516,87232,9.09523166666667,430.889068603516,72718550,451528
1043,436,430.889038085938,81324,9.10570166666667,430.889007568359,72852289,451964
1044,398,430.889038085938,85618,9.11620333333333,430.889038085938,72992789,452362
1045,402,430.889068603516,97588,9.12673833333333,430.889068603516,73150617,452764
1046,370,430.889129638672,88713,9.137185,430.889129638672,73293523,453134
1047,314,430.88916015625,80850,9.147675,430.889129638672,73425442,453448
1048,370,430.889282226563,92702,9.158175,430.889282226563,73572293,453818
1049,374,430.888977050781,87449,9.168725,430.888916015625,73717191,454192
1050,351,430.888916015625,79771,9.17916,430.888916015625,73850476,454543
1051,385,430.888916015625,77996,9.18965333333333,430.888885498047,73979237,454928
1052,402,430.888793945313,91982,9.20014,430.888793945313,74127166,455330
1053,417,430.888824462891,114531,9.21076666666667,430.888824462891,74310998,455747
1054,380,430.888916015625,101932,9.22112833333333,430.888946533203,74468162,456127
1055,360,430.88916015625,101189,9.23161666666667,430.889099121094,74631866,456487
1056,377,430.888854980469,85504,9.24210166666667,430.888854980469,74773423,456864
1057,658,430.888885498047,43045,9.252635,430.889007568359,74846701,457522
1059,512,430.888641357422,44142,9.26565166666667,430.889068603516,74917633,458034
1060,522,430.888793945313,54781,9.275065,430.889251708984,75002827,458556
1061,533,430.88916015625,44905,9.285025,430.889282226563,75071212,459089
1064,696,430.889343261719,45731,9.30218833333333,430.889282226563,75143036,459785
1065,588,430.889068603516,52511,9.31157,430.889343261719,75221977,460373
1066,615,430.889526367188,55436,9.32155333333333,430.889495849609,75304234,460988
1067,678,430.888793945313,44577,9.33135,430.889343261719,75379986,461666
1068,725,430.888793945313,50040,9.34126666666667,430.889190673828,75458596,462391
1069,527,430.888977050781,48015,9.35115,430.889282226563,75532534,462918
1071,576,430.888977050781,46044,9.36472,430.889251708984,75606794,463494
1072,617,430.888885498047,46078,9.37417166666667,430.889190673828,75680655,464111
1073,657,430.888977050781,41958,9.384455,430.889373779297,75746990,464768
1074,558,430.888977050781,48961,9.39422666666667,430.889373779297,75827211,465326
1075,734,430.889434814453,49126,9.40412,430.889312744141,75904852,466060
1078,623,430.888885498047,49102,9.42096833333333,430.889343261719,75982490,466683
1080,441,430.889190673828,93370,9.43378333333333,430.889099121094,76128223,467124
1081,302,430.889190673828,81925,9.44374166666667,430.88916015625,76258271,467426
1082,397,430.889282226563,85085,9.45424,430.889221191406,76395530,467823
1083,342,430.889190673828,81606,9.46479833333333,430.889190673828,76529465,468165
1084,350,430.889312744141,95045,9.47522166666667,430.889221191406,76681560,468515
1086,446,430.889038085938,102143,9.48922166666667,430.889038085938,76846839,468961
1087,371,430.88916015625,145880,9.49923833333333,430.889129638672,77078518,469332
1088,382,430.889129638672,106926,9.50969,430.889038085938,77254327,469714
1089,415,430.889129638672,115149,9.52017666666667,430.889068603516,77437744,470129
1090,638,430.890014648438,60256,9.53067166666667,430.889923095703,77540803,470767
1091,749,430.888885498047,59716,9.54120333333333,430.88916015625,77634414,471516
1092,612,430.888732910156,53113,9.550875,430.889038085938,77716409,472128
1093,663,430.889251708984,53054,9.56051833333333,430.889343261719,77803199,472791
1094,652,430.888793945313,54603,9.57030333333333,430.889190673828,77885112,473443
1095,548,430.888885498047,62043,9.58018166666667,430.889068603516,77985561,473991
1096,563,430.888977050781,61137,9.58984166666667,430.889190673828,78081068,474554
1097,577,430.889068603516,68790,9.599515,430.889282226563,78190412,475131
1098,619,430.888977050781,53539,9.60922666666667,430.889343261719,78278642,475750
1099,529,430.888793945313,60993,9.61903166666667,430.889129638672,78373472,476279
1100,523,430.888549804688,60042,9.62869333333333,430.888916015625,78471240,476802
1101,663,430.888732910156,66508,9.638395,430.88916015625,78577357,477465
1103,391,430.889038085938,110323,9.651995,430.889038085938,78750251,477856
1104,387,430.889068603516,109136,9.66196833333333,430.889007568359,78930252,478243
1105,362,430.888977050781,117299,9.672455,430.888977050781,79118713,478605
1106,492,430.888885498047,50319,9.682945,430.888977050781,79200980,479097
1107,550,430.888641357422,57251,9.69276,430.889038085938,79291907,479647
1109,583,430.888885498047,66110,9.70597833333333,430.888946533203,79396239,480230
1110,640,430.888732910156,62682,9.71514166666667,430.888977050781,79494401,480870
1113,334,430.88818359375,108178,9.73206666666667,430.88818359375,79671664,481204
1114,406,430.889129638672,110063,9.74142666666667,430.889038085938,79851938,481610
1115,328,430.889038085938,110230,9.75224833333333,430.888977050781,80031786,481938
1116,361,430.888916015625,109015,9.76246166666667,430.888885498047,80203852,482299
1117,416,430.888885498047,107232,9.77289833333333,430.888916015625,80379333,482715
1118,419,430.888885498047,103241,9.783405,430.888916015625,80547224,483134
1119,378,430.889068603516,104749,9.793905,430.889007568359,80717299,483512
1120,336,430.889099121094,94791,9.804435,430.889068603516,80868052,483848
1121,376,430.889465332031,80405,9.81487833333333,430.889434814453,80993626,484224
1122,625,430.888793945313,52621,9.825345,430.889038085938,81071208,484849
1123,596,430.888885498047,45282,9.835105,430.889007568359,81141684,485445
1125,410,430.889312744141,78602,9.84863833333333,430.889221191406,81269441,485855
1126,510,430.889282226563,78959,9.85860166666667,430.889190673828,81399271,486365
1127,616,430.889007568359,78913,9.86909166666667,430.889038085938,81534627,486981
1128,647,430.889038085938,83653,9.87963,430.889038085938,81676203,487628
1129,713,430.889038085938,85244,9.89007,430.889007568359,81819395,488341
1130,582,430.889221191406,66366,9.90066833333333,430.889312744141,81920792,488923
1131,506,430.888885498047,80409,9.91105166666667,430.888916015625,82049025,489429
1132,603,430.888946533203,87654,9.9216,430.888977050781,82192257,490032
1133,569,430.889068603516,83091,9.93205666666667,430.889038085938,82328724,490601
1134,541,430.889007568359,88643,9.94255833333333,430.888977050781,82470077,491142
1135,572,430.889068603516,99018,9.95304166666667,430.889007568359,82627456,491714
1136,455,430.889099121094,102263,9.96357833333333,430.889099121094,82791389,492169
1137,488,430.889221191406,93569,9.97401333333333,430.889099121094,82945289,492657
1138,567,430.889129638672,90377,9.984505,430.889038085938,83091873,493224
1139,470,430.889251708984,88778,9.99500666666667,430.889190673828,83234127,493694
1140,546,430.889038085938,90273,10.00555,430.888916015625,83378579,494240
1141,531,430.889221191406,100286,10.0163233333333,430.889221191406,83539058,494771
1142,497,430.889129638672,102306,10.0264733333333,430.889068603516,83702151,495268
1143,571,430.889221191406,103171,10.03697,430.889190673828,83871188,495839
1144,471,430.889221191406,98726,10.0475033333333,430.88916015625,84028385,496310
1145,525,430.889221191406,84343,10.0579466666667,430.889129638672,84168012,496835
1146,527,430.889221191406,96245,10.068525,430.889221191406,84320644,497362
1148,831,430.889251708984,95897,10.0824816666667,430.889282226563,84474849,498193
1149,908,430.889312744141,109883,10.0924783333333,430.889312744141,84651112,499101
1150,834,430.889221191406,91672,10.1029616666667,430.889221191406,84799570,499935
1152,865,430.889282226563,83225,10.11705,430.889343261719,84940303,500800
1153,770,430.889190673828,82340,10.1270116666667,430.889190673828,85071823,501570
1154,821,430.889221191406,78155,10.137535,430.889251708984,85204527,502391
1155,889,430.889129638672,69932,10.148,430.889190673828,85329471,503280
1156,829,430.889312744141,60680,10.158535,430.889312744141,85430732,504109
1157,828,430.889190673828,81626,10.1689733333333,430.88916015625,85564290,504937
1159,763,430.889343261719,62242,10.1830216666667,430.889343261719,85671500,505700
1160,515,430.889282226563,55143,10.1930283333333,430.889495849609,85758130,506215
1161,807,430.889251708984,73859,10.2034783333333,430.889221191406,85881354,507022
1163,625,430.889282226563,65607,10.2177866666667,430.889190673828,85995468,507647
1165,669,430.889312744141,65378,10.2315333333333,430.889312744141,86105607,508316
1166,623,430.889221191406,68583,10.2415883333333,430.889251708984,86224603,508939
1167,513,430.888641357422,44534,10.2523233333333,430.888977050781,86298126,509452
1168,600,430.889404296875,91028,10.262375,430.889373779297,86453756,510052
1169,545,430.889434814453,85643,10.2728216666667,430.889434814453,86596320,510597
1170,577,430.889190673828,109098,10.2833233333333,430.889190673828,86769578,511174
1171,490,430.889129638672,76894,10.293805,430.889099121094,86900114,511664
1172,613,430.890075683594,44126,10.304355,430.889923095703,86970597,512277
1173,452,430.888458251953,98041,10.3147783333333,430.888427734375,87132559,512729
1174,510,430.88916015625,96598,10.3244483333333,430.889129638672,87285839,513239
1176,476,430.889343261719,91322,10.3385483333333,430.889343261719,87429242,513715
1177,524,430.889129638672,98096,10.34853,430.889129638672,87581551,514239
1178,480,430.88916015625,102237,10.3590166666667,430.889099121094,87742033,514719
1179,497,430.889373779297,110855,10.3695033333333,430.889343261719,87919998,515216
1180,426,430.889373779297,105227,10.3800333333333,430.889343261719,88089493,515642
1181,412,430.889312744141,100562,10.3904866666667,430.889312744141,88253358,516054
1182,438,430.889221191406,101230,10.400985,430.889190673828,88413428,516492
1184,416,430.88916015625,106872,10.4151383333333,430.88916015625,88583642,516908
1185,491,430.889251708984,113221,10.4251166666667,430.889221191406,88765709,517399
1186,482,430.889221191406,114029,10.4355983333333,430.889221191406,88948724,517881
1188,418,430.889251708984,94193,10.4496266666667,430.889282226563,89096106,518299
1189,542,430.889678955078,60623,10.4595933333333,430.890014648438,89194809,518841
1191,528,430.888885498047,56017,10.473665,430.889251708984,89287340,519369
1192,667,430.888977050781,58670,10.4826566666667,430.889190673828,89377289,520036
1194,688,430.88916015625,48594,10.4958283333333,430.889373779297,89456873,520724
1195,491,430.889068603516,48108,10.50497,430.889190673828,89533484,521215
1197,360,430.889190673828,92350,10.5182033333333,430.889221191406,89685133,521575
1198,457,430.889007568359,86591,10.52817,430.888916015625,89822484,522032
1199,393,430.889312744141,103280,10.5386483333333,430.889221191406,89981941,522425
1200,424,430.888977050781,89946,10.5491433333333,430.889038085938,90126162,522849
1201,332,430.889099121094,88190,10.5596866666667,430.889068603516,90270844,523181
1202,324,430.889221191406,88097,10.5701416666667,430.88916015625,90415291,523505
1203,368,430.888793945313,95016,10.5807283333333,430.888824462891,90565282,523873
1204,344,430.889129638672,82546,10.5911166666667,430.889068603516,90700337,524217
1205,429,430.889221191406,99771,10.6016766666667,430.88916015625,90860363,524646
1206,386,430.888946533203,77024,10.6120816666667,430.889007568359,90986374,525032
1207,717,430.889923095703,41848,10.622575,430.890258789063,91052811,525749
1209,658,430.888793945313,50349,10.6366833333333,430.889129638672,91129881,526407
1211,580,430.888732910156,54530,10.649395,430.889129638672,91212567,526987
1212,622,430.888732910156,48043,10.6585966666667,430.888854980469,91285266,527609
1213,550,430.888977050781,44774,10.6683233333333,430.889038085938,91352755,528159
1214,582,430.888793945313,48464,10.678115,430.888946533203,91433146,528741
1215,302,430.888092041016,106011,10.687795,430.888092041016,91602438,529043
1216,384,430.889038085938,83950,10.6975433333333,430.889038085938,91737042,529427
1217,362,430.888946533203,102107,10.7080383333333,430.888977050781,91894709,529789
1218,448,430.888824462891,100481,10.7185783333333,430.888793945313,92057091,530237
1219,390,430.888916015625,95414,10.7290333333333,430.888946533203,92212787,530627
1220,384,430.889007568359,85685,10.739515,430.889038085938,92351502,531011
